00000000000001000000000000
00000000000001000000000000
00000000000001000000000000
00000000000001000000000000
00000000000001000000000000
00000000000001000000000000
11111111111111111111111111
00000000000001000000000000
00000000000001000000000000
00000000000001000000000000
00000000000001000000000000
00000000000001000000000000
00000000000001000000000000
11111111111111111111111111
10101010101010101010101010
00000000000001000000000000
00000000000001000000000000
00000000000001000000000000
00000000000001000000000000