22222222222222222222222222
22222222222222222222222222
22222222222222222222222222
00000000000010000000000000
00030003000010000000030000
00000000000010000000000000
11111111111111111111111111
00000000000010000000000000
00000000000010000000000003
33333333333013333333333333
33333333333013333333333330
00000000000010000000000000
00003300000010000000000000
11111111111111111111111111
00000000000010000000000000
00000003300010030000300000
00003000000010000000000300
00000030000010000300000000
00003330000010000000000003