22222222222222222222222222
22222222222222222222222222
22222222222222222222222222
00000000000001000000000000
00030003000001000000003000
00000000000001000000000000
11111111111111111111111111
00000000000001000000000000
00000000000001000000000000
33333333333331333333333333
33333333333331333333333333
00000000000001000000000000
00003300000001000000000000
11111111111111111111111111
00000000000001000000000000
00000003300001003000030000
00003000000001000000000030
00000030000001000030000000
00003330000001000000000000